különböző, sokféle, más-más, eltérő 	verschieden
hegyes, éles 	grell, herb, scharf
tizenhat 	sechzehn
között 	unter, mitten unter, zwischen
nadrág 	Hose
másmilyen, másik 	anderer, anders, sonst
köszönöm, kösz 	danke
cikk 	Abhandlung, Artikel
szél 	Wind
betegség 	Krankheit, Erkrankung
gyerta 	Kerze, Licht
tanul 	lernen
választék 	Auslese, Wahl
angol 	englisch; Engländer
szekrény 	Schrank
pék 	Bäcker
mos 	spülen, waschen
fáradt 	matt, müde
hír 	Neues, Neuheit, Neuigkeit
alap, bázis 	Basis, Grundlage
eléggé 	genug, genügend, hinlänglich, ziemlich
negyven 	vierzig
csókol 	küssen
gép 	Maschine
osztrák 	österreichisch; Österreicher
megszűnik 	aufhören
puha 	weich
meleg 	warm
szendvics 	Sandwich
fésű 	Kamm
gyár 	Fabrik
hold 	Mond
reggel 	Frühe, Morgen
határoz, dönt 	beschließen, entscheiden, sich entschließen
ló 	Gaul, Pferd
eleinte 	erst, erstens, zuerst
igen 	ja, doch; sehr
elfelejt 	vergessen
ügyvéd 	Advokat, Anwalt, Rechtsanwalt
paradicsom 	Tomate
mindenütt, mindenhol 	allenthalben, allerorten, überall
szomjas 	durstig
bárd 	Barde, Sänger
tizennégy 	vierzehn
megrongál, rongál 	beschädigen, Schaden zufügen, verderben, verletzen
szisztéma 	System
kör 	Kreis
tipikus 	typisch
öv 	Gurt, Gürtel
ül 	sitzen
veszélyes 	besorglich, gefährlich
lepcső 	Stiege, Treppe
húsvét 	Ostern
haj 	Haar
szerda 	Mittwoch
alvás 	Schlaf
honnan 	woher
leül 	sich setzen
katona 	Soldat
alig 	kaum
svájci 	Schweizer
csinos 	hübsch
tizenhárom 	dreizehn
szürke 	grau
blúz 	Bluse
beszélgetés 	Gespräch, Konversation, Unterhaltung
Írország 	Irland
hajó 	Schiff
borjú 	Kalb
gyomor 	Magen
péntek 	Freitag
hús 	Fleisch
igazi 	real, wirklich
bab 	Bohne
irányít 	dirigieren, führen, richten, steuern
hol 	wo
csillag 	Stern
fény 	Licht
hívás 	Ruf
Amerika 	Amerika
kijárat 	Ausgang
helyett 	an Stelle von, statt, anstatt
csónak 	Boot
nemzeti 	national
bámul, csodál 	bewundern
Franciaország 	Frankreich
saláta 	Salat
cél 	Ziel, Zweck
szöglet 	Winkel
flaska, üveg 	Flasche
föld 	Boden, Erdboden, Erde, Grund, Land, Terrain
sikerül 	Erfolg haben, gelingen
matematika 	Mathematik
így, amúgy 	so, auf diese Weise
válasz 	Antwort
ma 	heute
só 	Salz
piros 	rot
állat 	Tier
október 	Oktober
kilencven 	neunzig
utazási iroda 	Reisebüro
reklám, hirdetmény 	Annonce, Anzeige, Inserat
elfárad 	ermatten, ermüden
haz, ház 	Haus
hal 	Fisch
juh 	Hammel, Schaf
múzeum 	Museum
liszt 	Mehl
paszport, útlevél 	Pass, Reisepass
isten, Isten 	Gott
búza 	Weizen
széles 	ausgedehnt, geräumig, weit
fal 	Mauer, Wand
husáng, bot 	Stab, Stock
fekete 	schwarz
asszony, néni 	Frau
hetven 	siebzig
mészáros 	Fleischer
július 	Juli
fül 	Ohr
cím 	Adresse
név 	Name
szőlő 	Traube, Weintraube
úszik 	schwimmen
nagynéni 	Tante
lyuk 	Loch
citrom 	Zitrone
Ausztrália 	Australien
hangzik 	Hall, Klang, Laut, Schall, Ton
most 	jetzt, gegenwärtig, nun
utca 	Straße
változik 	ändern, tauschen, umändern, umtauschen, wechseln, umwechseln
bank 	Bank
jó éjszakát 	Gute Nacht
ajtó 	Tür
alszik 	schlafen; Schlaf
vaj 	Butter
burgonya, krumpli 	Erdapfel, Kartoffel
szomjúság 	Durst
lop 	entwenden, stehlen
énekel 	singen
esernyő 	Regenschirm
érett 	reif
ha 	falls, wenn
dáma, úrhölgy, hölgy 	Dame
pontos, precíz 	akkurat, genau
fejfájás 	Kopfschmerzen
nyilvántartás, adminisztráció 	Verwaltung
néha 	manchmal
pince 	Keller
szombat 	Samstag, Sonnabend; Sabbat
tenger 	Meer, See
hálószoba 	Schlafzimmer
egészég 	Gesundheit
felhő 	Wolke
szeptember 	September
sertés, disznó 	Schwein
gyógyszertár, patika 	Apotheke
vág 	schneiden
művészet 	Kunst
doboz 	Büchse, Schachtel
étlap 	Menü, Speisekarte
zsír 	Fett
kisbaba, bébi, baba 	Baby
odavezet 	bringen zu, führen zu, herbeischaffen, holen
kéz 	Hand
mérnök 	Ingenieur
sajt 	Käse
dollár 	Dollar
jó napot kívánok, jó napot 	Guten Morgen; Guten Tag
baráti 	freundlich, freundschaftlich
iskola 	Schule
visz 	tragen
kép, festmény 	Ansicht, Bild
feljelentés, besúgás 	Anzeige
könyvtár 	Bibliothek; Bücherei
nagy 	groß
mi, mit 	was
férfi 	Mann
akar 	wollen
tíz 	zehn
jön 	kommen
kilenc 	neun
négy 	vier
gyermek 	Kind
öt 	fünf
vagy 	oder
nyolc 	acht
három 	drei
egy 	ein, eine, eins
kell, muszáj, kötelező 	müssen, sollen
után 	hinter, nach
kis 	gering, klein
mikor 	als, wann, wenn
nem 	kein, nicht; nein
kettő 	zwei
ki, ami, amely, melyik 	der, die, das; welcher, welche, welches; wer
ott, oda 	da, dort
amíg 	bis
lesz 	geschehen, vorkommen, werden
hat 	sechs
utazik 	fahren; reisen
kefe 	Bürste
képes 	begabt, fähig, imstande, tüchtig
mond, szól 	erwähnen, sagen
Portugália 	Portugal
madár 	Vogel
viszlát, viszontlátásra, a viszontlátásra 	adieu, auf Wiedersehen, lebe wohl
tartani 	halten, aufhalten
Svédország 	Schweden
Spanyolország 	Spanien
nagyon 	sehr
tegnap 	gestern
a 	der, die, das
és 	und
dátum 	Datum
érvel 	argumentieren, beweisen
villa 	Gabel
összehív 	mitnehmen
május 	Mai
tűz 	Feuer
hónap 	Monat
barátság 	Freundschaft
pénz 	Geld
szerző 	Autor, Urheber, Verfasser; Schriftsteller
unokafivér 	Cousin, Vetter
íz 	Aroma, Duft; Geschmack
taxi 	Taxe, Taxi
mérges, haragos 	arg, böse
szőke 	blond
dél 	Süden
bejárat 	Eingang
füst 	Rauch
ár 	Preis
megszüntet 	beenden, unterbrechen
általánosan, általában 	generell, überhaupt
ezer 	tausend
gyakran 	häufig, oft
forr 	kochen, sieden, brausen
ablak 	Fenster
kilogramm 	Kilogramm
gyönyörű 	hübsch, schön; herrlich, stattlich, wunderbar
főzelék, zöldség 	Gemüse
barna 	braun
jó 	gut, gütig
kitép 	entreißen
térkép 	Karte
vér 	Blut
külföld 	Ausland
dzsem, gyümölcsiz 	Konfitüre, Marmelade
szem 	Auge
él 	leben
reggelizik 	frühstücken
mellett 	an, bei, neben; zu
tiszta 	blank, rein, reinlich, sauber
arc 	Angesicht, Antlitz, Gesicht
rombol 	vernichten, zerstören
újság 	Journal, Zeitung
kenyér 	Brot
összeköt 	verbinden
játég 	Spielzeug
jég 	Eis
európai 	Europäer
nyájas, barátságosan, barátian 	freundlich
vásárol 	kaufen, sich kaufen, einkaufen
font 	Pfund
asztal 	Tisch
tető 	Dach
tej 	Milch
épület 	Bau, Bauwerk, Gebäude
minőség 	Beschaffenheit, Güte, Qualität
eszik 	essen, fressen, genießen, speisen
levél 	Blatt; Brief
magas 	erhaben, hoch
álom, 	ábrándkép Traum
rovar 	Insekt
sárga 	gelb
alja 	Boden, Grund
éjszaka 	Nacht
bárány 	Lamm
Afrika 	Afrika
kedd 	Dienstag
benzin 	Benzin
ország 	Land
Németország 	Deutschland
fogkefe 	Zahnbürste
színes, tarka 	bunt
elalszik 	einschlafen
tisztelet 	Ehre
tánc 	Tanz
holnapután 	übermorgen
szín 	Farbe
zene 	Musik
onnan 	daher
vendég 	Gast
semmi 	nichts
előtt 	jüngst, vor
kapu 	Tor
sonka 	Schinken
húsz 	zwanzig
szalad 	laufen
alkalmas 	tauglich, tüchtig
leültet, ültet 	setzen
út 	Bahn, Chaussee, Strecke, Weg
keményítő 	Kraftmehl, Stärke
pihen 	ruhen, sich ausruhen
édes 	süß
rátesz 	anziehen
közben, míg, alatt 	während
kitűnő 	ausgezeichnet, gediegen, trefflich, vortrefflich, vorzüglich
balkon, erkély 	Balkon
gramm 	Gramm
garázs 	Garage
szakáll 	Bart
nélkül 	ohne
káposzta 	Kohl
hegy 	Halde, Hügel; Berg
város 	Ort, Stadt
bélyeg 	Briefmarke
fém 	Metall
híd 	Brücke
üres 	leer
német 	deutsch; Deutsche; Deutscher
utálni 	hassen
labda, bál 	Ball
ceruza 	Bleistift